"filename", "language", "JavaScript", "JavaScript JSX", "comment", "blank", "total"
"c:\Users\DigitalMix3\Desktop\apis\mixconnect-front-text\src\GlobalStyled.jsx", "JavaScript JSX", 0, 39, 0, 0, 39
"c:\Users\DigitalMix3\Desktop\apis\mixconnect-front-text\src\components\Card\Card.jsx", "JavaScript JSX", 0, 2, 0, 0, 2
"c:\Users\DigitalMix3\Desktop\apis\mixconnect-front-text\src\components\Card\CardStyled.jsx", "JavaScript JSX", 0, 6, 0, 0, 6
"c:\Users\DigitalMix3\Desktop\apis\mixconnect-front-text\src\components\Delete\Delete.jsx", "JavaScript JSX", 0, -1, 0, 0, -1
"c:\Users\DigitalMix3\Desktop\apis\mixconnect-front-text\src\components\Input\Input.jsx", "JavaScript JSX", 0, 4, 0, 0, 4
"c:\Users\DigitalMix3\Desktop\apis\mixconnect-front-text\src\components\Input\InputStyled.jsx", "JavaScript JSX", 0, 4, 0, 0, 4
"c:\Users\DigitalMix3\Desktop\apis\mixconnect-front-text\src\components\Navbar\Navbar.jsx", "JavaScript JSX", 0, 44, -7, 2, 39
"c:\Users\DigitalMix3\Desktop\apis\mixconnect-front-text\src\components\Navbar\NavbarStyled.jsx", "JavaScript JSX", 0, 26, 0, 0, 26
"c:\Users\DigitalMix3\Desktop\apis\mixconnect-front-text\src\components\SkeletonCard\SkeletonCard.jsx", "JavaScript JSX", 0, 19, 3, 3, 25
"c:\Users\DigitalMix3\Desktop\apis\mixconnect-front-text\src\components\SkeletonCard\SkeletonCardStyled.jsx", "JavaScript JSX", 0, 0, 0, 1, 1
"c:\Users\DigitalMix3\Desktop\apis\mixconnect-front-text\src\components\Task\Task.jsx", "JavaScript JSX", 0, 13, 0, 0, 13
"c:\Users\DigitalMix3\Desktop\apis\mixconnect-front-text\src\components\Task\TaskStyled.jsx", "JavaScript JSX", 0, 30, 0, 1, 31
"c:\Users\DigitalMix3\Desktop\apis\mixconnect-front-text\src\main.jsx", "JavaScript JSX", 0, 14, 1, 0, 15
"c:\Users\DigitalMix3\Desktop\apis\mixconnect-front-text\src\pages\ChoreTasks\ChoreTasks.jsx", "JavaScript JSX", 0, 43, 1, 6, 50
"c:\Users\DigitalMix3\Desktop\apis\mixconnect-front-text\src\pages\Client\Client.jsx", "JavaScript JSX", 0, 501, 1, 24, 526
"c:\Users\DigitalMix3\Desktop\apis\mixconnect-front-text\src\pages\Client\ClientStyled.jsx", "JavaScript JSX", 0, 51, 0, 4, 55
"c:\Users\DigitalMix3\Desktop\apis\mixconnect-front-text\src\pages\Clients\Clients.jsx", "JavaScript JSX", 0, 343, 0, 15, 358
"c:\Users\DigitalMix3\Desktop\apis\mixconnect-front-text\src\pages\Clients\ClientsStyled.jsx", "JavaScript JSX", 0, 151, 0, 4, 155
"c:\Users\DigitalMix3\Desktop\apis\mixconnect-front-text\src\pages\Employee\Employee.jsx", "JavaScript JSX", 0, 13, 0, 3, 16
"c:\Users\DigitalMix3\Desktop\apis\mixconnect-front-text\src\pages\Employees\Employees.jsx", "JavaScript JSX", 0, 6, 0, 0, 6
"c:\Users\DigitalMix3\Desktop\apis\mixconnect-front-text\src\pages\Employees\EmployeesStyled.jsx", "JavaScript JSX", 0, -5, 0, 0, -5
"c:\Users\DigitalMix3\Desktop\apis\mixconnect-front-text\src\pages\Home\Home.jsx", "JavaScript JSX", 0, 82, 0, 3, 85
"c:\Users\DigitalMix3\Desktop\apis\mixconnect-front-text\src\pages\Home\HomeStyled.jsx", "JavaScript JSX", 0, 83, 0, 3, 86
"c:\Users\DigitalMix3\Desktop\apis\mixconnect-front-text\src\pages\Logins\Logins.jsx", "JavaScript JSX", 0, 271, 1, 14, 286
"c:\Users\DigitalMix3\Desktop\apis\mixconnect-front-text\src\pages\Logins\LoginsStyled.jsx", "JavaScript JSX", 0, 89, 0, 3, 92
"c:\Users\DigitalMix3\Desktop\apis\mixconnect-front-text\src\pages\Plans\PlanStyled.jsx", "JavaScript JSX", 0, 163, 0, 5, 168
"c:\Users\DigitalMix3\Desktop\apis\mixconnect-front-text\src\pages\Plans\Plans.jsx", "JavaScript JSX", 0, 207, 9, 13, 229
"c:\Users\DigitalMix3\Desktop\apis\mixconnect-front-text\src\pages\Profile\Profile.jsx", "JavaScript JSX", 0, 10, 0, 0, 10
"c:\Users\DigitalMix3\Desktop\apis\mixconnect-front-text\src\pages\Profile\ProfileStyled.jsx", "JavaScript JSX", 0, 4, 0, 0, 4
"c:\Users\DigitalMix3\Desktop\apis\mixconnect-front-text\src\services\choreService.js", "JavaScript", 12, 0, 1, 1, 14
"c:\Users\DigitalMix3\Desktop\apis\mixconnect-front-text\src\services\clientService.js", "JavaScript", 66, 0, 1, 6, 73
"c:\Users\DigitalMix3\Desktop\apis\mixconnect-front-text\src\services\employeeService.js", "JavaScript", -1, 0, 1, 0, 0
"c:\Users\DigitalMix3\Desktop\apis\mixconnect-front-text\src\services\loginService.js", "JavaScript", 54, 0, 2, 8, 64
"c:\Users\DigitalMix3\Desktop\apis\mixconnect-front-text\src\services\ltvService.js", "JavaScript", 14, 0, 2, 5, 21
"c:\Users\DigitalMix3\Desktop\apis\mixconnect-front-text\src\services\planService.js", "JavaScript", 43, 0, 2, 7, 52
"Total", "-", 188, 2212, 18, 131, 2549