"filename", "language", "JavaScript JSX", "JavaScript", "XML", "comment", "blank", "total"
"c:\Users\DigitalMix3\Desktop\apis\mixconnect-front-text\src\App.jsx", "JavaScript JSX", 5, 0, 0, 0, 2, 7
"c:\Users\DigitalMix3\Desktop\apis\mixconnect-front-text\src\GlobalStyled.jsx", "JavaScript JSX", 212, 0, 0, 0, 2, 214
"c:\Users\DigitalMix3\Desktop\apis\mixconnect-front-text\src\assets\react.svg", "XML", 0, 0, 1, 0, 0, 1
"c:\Users\DigitalMix3\Desktop\apis\mixconnect-front-text\src\components\Button\Button.jsx", "JavaScript JSX", 8, 0, 0, 1, 2, 11
"c:\Users\DigitalMix3\Desktop\apis\mixconnect-front-text\src\components\Button\ButtonStyled.jsx", "JavaScript JSX", 15, 0, 0, 0, 2, 17
"c:\Users\DigitalMix3\Desktop\apis\mixconnect-front-text\src\components\Card\Card.jsx", "JavaScript JSX", 15, 0, 0, 3, 2, 20
"c:\Users\DigitalMix3\Desktop\apis\mixconnect-front-text\src\components\Card\CardStyled.jsx", "JavaScript JSX", 5, 0, 0, 0, 2, 7
"c:\Users\DigitalMix3\Desktop\apis\mixconnect-front-text\src\components\CreateEmployee\CreateEmployee.jsx", "JavaScript JSX", 49, 0, 0, 1, 3, 53
"c:\Users\DigitalMix3\Desktop\apis\mixconnect-front-text\src\components\CreateEmployee\CreateEmployeeStyled.jsx", "JavaScript JSX", 44, 0, 0, 0, 2, 46
"c:\Users\DigitalMix3\Desktop\apis\mixconnect-front-text\src\components\Navbar\Navbar.jsx", "JavaScript JSX", 8, 0, 0, 2, 3, 13
"c:\Users\DigitalMix3\Desktop\apis\mixconnect-front-text\src\components\UpdateEmployee\UpdateEmployee.jsx", "JavaScript JSX", 44, 0, 0, 1, 3, 48
"c:\Users\DigitalMix3\Desktop\apis\mixconnect-front-text\src\components\UpdateEmployee\UpdateEmployeeStyled.jsx", "JavaScript JSX", 46, 0, 0, 0, 2, 48
"c:\Users\DigitalMix3\Desktop\apis\mixconnect-front-text\src\main.jsx", "JavaScript JSX", 24, 0, 0, 1, 3, 28
"c:\Users\DigitalMix3\Desktop\apis\mixconnect-front-text\src\pages\Home\Home.jsx", "JavaScript JSX", 88, 0, 0, 1, 8, 97
"c:\Users\DigitalMix3\Desktop\apis\mixconnect-front-text\src\pages\Home\HomeStyled.jsx", "JavaScript JSX", 29, 0, 0, 0, 5, 34
"c:\Users\DigitalMix3\Desktop\apis\mixconnect-front-text\src\services\employeeService.js", "JavaScript", 0, 22, 0, 1, 6, 29
"Total", "-", 592, 22, 1, 11, 47, 673